##############
#....#....#..#
#..G.#....#..#
#....#....#..#
############################
#....#....#..#
#..G.#....#..#
#....#....#..#
##############
#............#
#....######..#
#..G.######..#
#....######..#
##############
#............#
#..#########.#
#..G.........#
#..#########.#
##############