......############
......#..........#
......#..P.......#
......#..........#.............................#######################
......#..........#.............................#.....................#
#######.......G..#.............................#.....................X
#................#...........###########.......#.................S...X
#.......S........#############.........#.......#.....................#
#.................................S....#.......#.....................#
#................#############.........#########.......G.G.G.G.......#
#######..........#...........#.......................................#
......#........G.#...........#....S....#########.....................#
......#..........#...........#.........#.......#.....S...........S...#
......#..........#...........###########.......#.....................#
......#########.##.............................#.....................#
..............#.#..............................###.###################
..............#.##################################.#
..............#...................................G#
..............######################################