##############
#.........#..#
#..G.#..P.#.S#
#....#.......#
########X#####