##############
#............#
#..G...P...S.#
#............#
##############